1111111111111
10P1000000CC1
100P011111001
100011E000101
1111111111111