1111111111111
1001000000CC1
100P011111001
100011E000101
1111111111111