1111111111111
10P1000000CC1
1000011111001
100011E000001
1111111111111